Business	City	State
RPX Corporation	"San Francisco, CA"	
"Jackson Square Aviation, LLC"	"San Francisco, CA"	
Critigen LLC	"San Francisco, CA"	
"Harvest Capital Strategies, LL"	"San Francisco, CA"	
Medicines360	"San Francisco, CA"	
Nasam Incorporated	"South San Francisco, CA"	
Pattern Energy Group LP	"San Francisco, CA"	
San Francisco General Hospital Foundation	"San Francisco, CA"	
"Avenue Code, LLC"	"San Francisco, CA"	
"Blujett, LLC"	"San Francisco, CA"	
California Pacific Medical Center	"San Francisco, CA"	
"Sega Gameworks U.S.A., Inc."	"San Francisco, CA"	
Andover Printing Services Ltd.	"South San Francisco, CA"	
Dept of Epidemiology &amp; Biostatistics	"San Francisco, CA"	
Periera &amp; O'Ddell LLC	"San Francisco, CA"	
Lateral Designs Inc.	"San Francisco, CA"	
Direct To Home Appliances LLC	"San Francisco, CA"	
Emergent Ventures International Inc.	"San Francisco, CA"	
"Triple Aught Design, LLC"	"San Francisco, CA"	
"Meca Builders, Inc."	"San Francisco, CA"	
Fairmont Heritage Place Ghirardelli Square	"San Francisco, CA"	
"San Francisco Institute of Esthetics and Cosmetology, Incorporated"	"San Francisco, CA"	
"Universal Airlines, Inc."	"San Francisco, CA"	
"Castlight Health, Inc."	"San Francisco, CA"	
"Marriott International, Inc."	"San Francisco, CA"	
